XXXXXXXXXXXX
XX-X----XXXX
XXX-XXXX--XX
XXX--------X
X{----X-X--X
XXX-XXXXXXXX
XXX-XXXXXXXX
X----------X
X-XXX---X-XX
XX------X-XX
X-----X-X-XX
XXXX-----XXX
XXXX--X--XXX
X---XX-XX-}X
XXXXXXXXXXXX
META {"type": "solver", "value": "pysat-rc2"}
