------------------
------------------
------------------
---------------S--
------------------
------------------
------------------
------------------
-------Q------S---
----------S-------
------------------
--------------}---
--{-----------X---
XXXXX-------XXXXXX
