------------------
------------------
------------------
------------------
------------------
------------------
------------------
------------------
------S--------S--
---------SQSQ-----
------------------
---------------}--
--{------------X--
XXXXX-------XXXXXX
META {"type": "solver", "value": "pysat-rc2"}
