XXXXXXXXXXXX
X-XXX------X
XXXXXX-XXXXX
XXXXXX-XXXXX
XXXX{-X----X
XXXXXX-XXX-X
XXXXXX-----X
X------X---X
X-XXXXX-XXXX
X-XXXXX-XXXX
X------X---X
X---XX-X-XXX
X---XX-X-XXX
X---------}X
XXXXXXXXXXXX
