XXXXXXXXXXXX
X{-X-------X
XXX----XXX-X
XXX--XXXXX-X
X--X-XXXXX-X
XX-----XX-XX
X--X-X-----X
X----X-----X
XX---X-XXX-X
XXX-------XX
XXXXXXX----X
XXXXXXX-XXXX
XX------XXXX
X---------}X
XXXXXXXXXXXX
