------------------
------------------
------------------
------------------
------------------
------------------
------------------
-----SS-----------
------------------
------------------
-----Q--SSQ-------
---------------}--
--{------------X--
XXXXX---XX---XXXXX
META {"type": "solver", "value": "pysat-rc2"}
