------------------
------------------
------------------
------------------
---SQ-------------
------------------
------------------
------SSS---------
------------------
------------------
-------X--Q-------
------XX------}---
--{--XXX------X---
XXXXXXXX----XXXXXX
