------------------
------------------
------------------
------------------
---------------S--
------------------
------------------
-----------SQS----
-------Q----------
------------------
------------------
--------------}---
--{-----------X---
XXXXX------XXXXXXX
