XXXXXXXXXXXX
XXX---XX---X
XXX--------X
X{-XX--XX--X
XXXXXXXXXXXX
XXXXXXXXXXXX
X----------X
X--X--XXX--X
XX-X-----XXX
X--X-X---XXX
XXX-X-XX--}X
XXX---XX-XXX
XXX------XXX
X----------X
XXXXXXXXXXXX
META {"type": "solver", "value": "pysat-rc2"}
