XXXXXXXXXXXX
X{--------XX
XXXXXXXXXX-X
XXXXXXXXXX-X
X---------XX
XX------X-XX
XXX-XXX--XXX
XXX------XXX
XX-----X-XXX
XX-X-X-X--XX
X--X-X-X---X
X--X-X---XXX
XX--X----XXX
X-XX--XX--}X
XXXXXXXXXXXX
