------------------
------------------
--------S---------
------------------
-----S-----S--S---
------------------
------------------
------Q-----------
------------------
----------Q-------
------------------
---------------}--
---{-----------X--
XXXXXX-------XXXXX
