XXXXXXXXXXXX
X{-XXXXXXX-X
XXXXXXXXXX-X
XXXXXX-XX-XX
X-----X----X
X-XXX-X-X-XX
XX----X--X-X
XX-----XX-XX
X--XXX-XX-XX
X--XXX-----X
X-----XX---X
XXXXXXXXXXXX
XXXXXXXXXXXX
X---------}X
XXXXXXXXXXXX
