XXXXXXXXXXXX
X{-X-------X
XXX-----X--X
XXX-XXX-X-XX
X-------X-XX
X----XX----X
X--XXXXXXXXX
X--XXXXXXXXX
X--XXXX----X
X--XXX-----X
X--XXXX--XXX
X--XXXX--XXX
X--------XXX
X--XX--XX-}X
XXXXXXXXXXXX
