------------------
------------------
------SSQ---------
------------------
------------------
------------------
------------------
------------------
---S---X----------
-------XX---------
-------XXX--------
-------XXXX---}---
---{---XXXXX--X---
XXXXXXXXXXXXXXXXXX
META {"type": "solver", "value": "pysat-rc2"}
