XXXXXXXXXXXX
X{---X-X--XX
XXXXX---X--X
XXXXX--X-XXX
X----XX--XXX
XX-XXXXX---X
XX-XXXXXX-XX
X--XXXXXX--X
X----------X
X-----XXX--X
X-X-XX-----X
X-X-XX--XXXX
X-X-----XXXX
X--XX-----}X
XXXXXXXXXXXX
