------------------
------------------
------------------
------------------
------------------
------------------
----------S-------
-----SS-------S---
------------------
----------Q-------
-----Q------------
--------------}---
--{-----------X---
XXXXX-------XXXXXX
