XXXXXXXXXXXX
X---X----X-X
XXX-----X--X
XXX-----X-XX
X{---XX-X--X
XXXXXXXX--XX
XXXXXXXX-X-X
X----XXX---X
X-XXX------X
XX---XX----X
XX-XXXXX---X
X-XXXXXX-XXX
X-XXXXXX-XXX
X---------}X
XXXXXXXXXXXX
META {"type": "solver", "value": "pysat-rc2"}
