------------------
------------------
------------------
------------------
------------------
------------------
-----------S------
------------------
--------S-----S---
-----------Q------
------------------
---------------}--
---{-----------X--
XXXXXX------XXXXXX
META {"type": "solver", "value": "pysat-rc2"}
