------------------
------------------
------------------
------------------
------------------
------------------
------------------
-----SSQ----------
------------------
------------------
-----SQ--S--------
---------------}--
--{------------X--
XXXXXX-------XXXXX
