XXXXXXXXXXXX
X---X----X-X
XXXX-XXXX-XX
XXXX-XXXX-XX
X{---XXXX-XX
XXX------XXX
XXX-X----XXX
X---X-----XX
X---X-XX-XXX
X-----XX-XXX
XX-XXX--X-}X
X------X-XXX
X--------XXX
X----------X
XXXXXXXXXXXX
