XXXXXXXXXXXX
XXXX{--X-X-X
XXXXXXX---XX
XXXXXXX---XX
XX-----XXX-X
X-XXX-X----X
X------XXX-X
X----XX----X
XX-XXXXX--XX
XX-XXXXX--XX
X-X-----X--X
X-X--XXXXXXX
X-X--XXXXXXX
X--XX-----}X
XXXXXXXXXXXX
META {"type": "solver", "value": "pysat-rc2"}
