XXXXXXXXXXXX
XX---XXXX-XX
XXX--------X
XXX-XX-XX--X
X{-XXXXXXXXX
XXXXXXXXXXXX
XXXXXX-----X
X------XXXXX
X-XXXX-XXXXX
X----------X
XX----X----X
XX----X-XXXX
X-XXX-X-XXXX
X---------}X
XXXXXXXXXXXX
