XXXXXXXXXXXX
XXX-X-XXXXXX
XXX----XX--X
X{-XXX-----X
XXX---XXXXXX
XXX-X-XXXXXX
X----X-----X
X------XXXXX
X-XXX--XXXXX
X----XX----X
X-X-XXXX---X
X-X-XXXX-XXX
X-X------XXX
X---XX-XX-}X
XXXXXXXXXXXX
META {"type": "solver", "value": "pysat-rc2"}
