------------------
------------------
------------------
------------------
------------------
------------------
------------------
-----SQ---SSS-----
------------------
------------------
-----Q--X---------
--------XX----}---
--{-----XXX---X---
XXXXX---XXXXXXXXXX
