XXXXXXXXXXXX
XXXXXXX-X--X
XX{-XXX----X
XXXXXXXX---X
XXXXXXXX--XX
X---XX--XX-X
X-X----XXXXX
X-X----XXXXX
X-X-XXX-XX-X
X----------X
X-XX-XX-XX-X
XXXXXXXXXXXX
XXXXXXXXXXXX
X---------}X
XXXXXXXXXXXX
META {"type": "solver", "value": "pysat-rc2"}
