------------------
------------------
------------------
------------------
---------------S--
------------------
------------------
---------Q--------
------------------
------------------
-----------Q------
-------X-------}--
---{--XX-------X--
XXXXXXXX-----XXXXX
