XXXXXXXXXXXXXXXXXXXX
XXXXXXXXXXXXXXXXXXXX
X------------------X
X------------------X
X------------------X
X-----XXXXXXXX------
X-----XXXXXXXX------
X-----------------}-
X---------------XXXX
X---------------XXXX
X--------XXXX---XXXX
XXXXXX---XXXX------X
XXXXXX-------------X
XXXXXX-------------X
-------------------X
-------------------X
---------{---------X
XXXXXXXXXXXXXXXXXXXX
XXXXXXXXXXXXXXXXXXXX
XXXXXXXXXXXXXXXXXXXX
