XXXXXXXXXXXX
X{---XX-XX-X
XXXXX------X
XXXXX---XX-X
X----XXXXXXX
X----XXXXXXX
XXX--------X
XXX--XX--XXX
X----XX-XXXX
X-X-----XXXX
X-X-XXX--}XX
X-X-----XXXX
X-------XXXX
X-XX-XX----X
XXXXXXXXXXXX
META {"type": "solver", "value": "pysat-rc2"}
