XXXXXXXXXXXX
XXXX-------X
XXXX-----X-X
XXXX---X-X-X
XX{-XXX--X-X
XXXX-------X
XXXX-------X
X----------X
X-XX---XXX-X
XXXXXX-XXX-X
XXXXXX-----X
X-XX--X-XXXX
X-------XXXX
X--XX-XX--}X
XXXXXXXXXXXX
