------------------
------------------
------------------
------------------
------------------
-----Q--S---------
------------------
------------------
---------Q--------
---S--------------
------------S-----
---------------}--
---{--XX-------X--
XXXXXXXX-----XXXXX
META {"type": "solver", "value": "pysat-rc2"}
