------------------
------------------
------------------
------------------
------------------
--------------Q---
------------------
------SSSS--------
------------------
------------------
-------X----------
------XX-------}--
--{--XXX-------X--
XXXXXXXX-----XXXXX
META {"type": "solver", "value": "pysat-rc2"}
