------------------
------------------
------------------
------------------
------------------
------------------
------------------
------------------
--------Q--SSSQS--
------------------
------------------
----------X---}---
--{-------XX--X---
XXXXX-----XXXXXXXX
META {"type": "solver", "value": "pysat-rc2"}
