XXXXXXXXXXXX
X--XXXXXXXXX
XXX-----XX-X
XXX-X------X
X{-X-XXX---X
XXX-X---XX-X
XXXXXXXXXXXX
XXXXXXXXXXXX
XX---------X
X------X---X
X------X---X
X--XXX-X-XXX
X--XXX---XXX
X-----XX--}X
XXXXXXXXXXXX
META {"type": "solver", "value": "pysat-rc2"}
