------------------
------------------
------------------
------------------
------------------
------------------
------------------
-------SQ---------
------------------
------------------
-------Q--SSS-----
---------------}--
---{-----------X--
XXXXXX------XXXXXX
