XXXXXXXXXXXX
XXXX-------X
XX{-X-XXX--X
XXXX-------X
XXXX-XX-XX-X
X---XXXXXXXX
X---XXXXXXXX
X-X-----XX-X
X-X--------X
X-X--XX-X--X
XX-XXXXX-XXX
X--XXXXX-XXX
XX---XX--XXX
X--XX--XX-}X
XXXXXXXXXXXX
META {"type": "solver", "value": "pysat-rc2"}
