------------------
------------------
------------------
------------------
------------------
------------------
------------------
------SSQS--------
--------------S---
------------------
-------XX--Q------
------XXX------}--
--{--XXXX------X--
XXXXXXXXX----XXXXX
