XXXXXXXXXXXX
X{-X-------X
XXX--------X
XXX--------X
X----------X
XXXX---XXX-X
XXXX-------X
X---XXX-XX-X
X---XXXXXXXX
X---XXXXXXXX
X-X----}XXXX
X-X-X-XXXXXX
X-X---XXXXXX
X----------X
XXXXXXXXXXXX
META {"type": "solver", "value": "pysat-rc2"}
