------------------
------------------
------------------
------------------
---S--------------
------Q-----------
------------------
------------------
--------S---------
---SS-------Q-----
------------------
---------------}--
--{------------X--
XXXXXX-------XXXXX
