------------------
------------------
------------------
------------------
--------------S---
---SSS--Q---------
------------------
-----------Q------
------X-----------
------XX----------
------XXX---------
------XXXX-----}--
--{---XXXXX----X--
XXXXXXXXXXXXXXXXXX
