XXXXXXXXXXXX
XXX-X------X
X{--------XX
XXX-XXXXX--X
XXX-------XX
X--X------XX
XXXXXXX--XXX
XXXXXXX--XXX
X--------XXX
X--X-X---XXX
X--X-X-----X
XX-X-X-XXXXX
XX--X--XXXXX
X-XX-XX---}X
XXXXXXXXXXXX
META {"type": "solver", "value": "pysat-rc2"}
