XXXXXXXXXXXX
XXX--X-XXXXX
X{-X----XX-X
XXX--------X
XXX---XXX--X
XXX-X----X-X
XXXXXXX-X-XX
XXXXXXX-X--X
X-------X-XX
X---------XX
X----------X
XXXXXXXX-XXX
XXXXXXXX-XXX
X---------}X
XXXXXXXXXXXX
META {"type": "solver", "value": "pysat-rc2"}
