XXXXXXXXXXXX
X{-X-X----XX
XXX---XXXXXX
XXX-X-XXXXXX
X----------X
XXX-X-XXXX-X
XXX-X------X
XXX-X-XXXXXX
X----XXXXXXX
XX---XXXXXXX
X-----XX--}X
X-------XXXX
X-------XXXX
X-XX--XX---X
XXXXXXXXXXXX
META {"type": "solver", "value": "pysat-rc2"}
