------------------
------------------
------------------
------------------
------------------
------------------
---S----S---------
------------------
------------------
----------Q-------
-----SQ-----------
---------------}--
--{------------X--
XXXXXX-------XXXXX
META {"type": "solver", "value": "pysat-rc2"}
