XXXXXXXXXXXX
X--X-------X
XXX--------X
XXX--------X
X{-X---XXX-X
XXX--------X
XXX--XXX--XX
X--XXXXX--XX
X--XXXXX--XX
X----XX-XXXX
X---X--XXXXX
X---X--XXXXX
X---X----XXX
X-XX------}X
XXXXXXXXXXXX
META {"type": "solver", "value": "pysat-rc2"}
