XXXXXXXXXXXX
X---X------X
XXX----XXX-X
XXX---XXXXXX
X{-XX-XXXXXX
XXXXXX--XX-X
XXXXXX-----X
X------XXX-X
XX----X----X
XX-XX-X-X--X
XX-XX-X--XXX
X----X---XXX
XX-------XXX
X---XX-XX-}X
XXXXXXXXXXXX
META {"type": "solver", "value": "pysat-rc2"}
