XXXXXXXXXXXXXXXXXXXX
XXXXXXXXXXXXXXXXXXXX
X------------------X
X------------------X
X------------------X
X----XXXXXXXX-------
X----XXXXXXXX-------
X----XXXXXXXX-----}-
X---------------XXXX
X---------------XXXX
X---------------XXXX
XXXXXXX---XXX------X
XXXXXXX---XXX------X
XXXXXXX---XXX------X
-------------------X
-------------------X
--------{----------X
XXXXXXXXXXXXXXXXXXXX
XXXXXXXXXXXXXXXXXXXX
XXXXXXXXXXXXXXXXXXXX
