------------------
------------------
---------------S--
------------------
------------------
------------------
------------------
-------S----------
--------------Q---
----------SQ------
------------------
---------------}--
---{-----------X--
XXXXXX-------XXXXX
