------------------
------------------
------------------
------------------
-----------SSQS---
------------------
------------------
------------------
--------Q---------
-----------S------
------------------
---------------}--
--{--XX--------X--
XXXXXXX------XXXXX
