------------------
------------------
------------------
------------------
------------------
------------------
-------Q----------
------------------
------------------
------------------
-----S----SSQ-----
---------------}--
--{------------X--
XXXXX-------XXXXXX
