XXXXXXXXXXXX
XXX--X-----X
XXXXX-XXXXXX
XXXXX-XXXXXX
XXX{-X-----X
XXXXX---XX-X
XXXXX-XXXXXX
X-----XXXXXX
XXXX-X-----X
XXXX-X-XXX-X
X----X-----X
X--------XXX
X--------XXX
X--XX--XX-}X
XXXXXXXXXXXX
