XXXXXXXXXXXX
X{--XXX--XXX
XXX-XXX--XXX
XXX------XXX
X--X-------X
XX--X------X
X---X-XXX--X
X---X------X
XX---X----XX
X-X---XX---X
XXXXX-XX--XX
XXXXX---XXXX
X-------XXXX
X----XX---}X
XXXXXXXXXXXX
