XXXXXXXXXXXX
X---X--XX--X
XXXX-X---X-X
XXXX-----X-X
X{--X----X-X
XXXX-------X
XXXX-------X
X---XX-XXX-X
XX-XXXXXXXXX
X--XXXXXXXXX
XX-XXX-}XXXX
X-----XXXXXX
X-XXX-XXXXXX
X----------X
XXXXXXXXXXXX
