------------------
------------------
------------------
------------------
------------------
---SSSQ--Q----S---
------------------
------------------
--------X---------
--------XX--------
--------XXX-------
--------XXXX---}--
---{----XXXXX--X--
XXXXXX--XXXXXXXXXX
META {"type": "solver", "value": "pysat-rc2"}
