XXXXXXXXXXXX
X{-XXX----XX
XXX----XXX-X
XXX-X-----XX
X---X-----XX
XX--X--X---X
XX--------XX
X-XXXXX----X
X-XXXXX----X
X-XXXXX---XX
X-XXXX-----X
X-XXX----XXX
XX-------XXX
X-XX------}X
XXXXXXXXXXXX
