------------------
------------------
------------------
------------------
------------------
------------------
-----SSSS---------
------------------
------------------
----------Q-------
-----<>-----------
-----[]--------}--
--{--[]--------X--
XXXXXXXXX----XXXXX
META {"type": "solver", "value": "pysat-rc2"}
