XXXXXXXXXXXX
X{-X---XX--X
XXX--------X
XXX--------X
XXX----XXX-X
X----XX----X
XXXXXXXX---X
XXXXXXXXXXXX
X----XXXXXXX
XX---XXXXXXX
X---X----}XX
X---X---XXXX
X---X---XXXX
X-XX-XX----X
XXXXXXXXXXXX
