------------------
------------------
---Q--------------
------------------
------------------
---S--------------
--------Q---------
-------------S----
------------------
----------S-------
-----<>-----------
-----[]--------}--
--{--[]--------X--
XXXXXXXXX----XXXXX
META {"type": "solver", "value": "pysat-rc2"}
