XXXXXXXXXXXX
XXX--X-XXX-X
XXX--------X
X{-X-XX----X
XXXXXXXX--XX
XXXXXXXX---X
X----XX--X-X
X--------X-X
X-XX--XX-X-X
XXXXXXXXX--X
XXXXXXXXX-XX
X-XX-----XXX
XX---XXX-XXX
X---------}X
XXXXXXXXXXXX
META {"type": "solver", "value": "pysat-rc2"}
