------------------
------------------
------------------
------------------
--------------S---
------------------
------------------
--------------S---
-------Q--Q-------
------------------
------------------
----------X----}--
--{-------XX---X--
XXXXX-----XXXXXXXX
