------------------
------------------
------------------
------------------
------------------
------------------
------------------
------SS--S-------
------------------
------------------
------Q---S-------
--------------}---
--{-----------X---
XXXXX-------XXXXXX
