------------------
------------------
------------------
------------------
------------------
-----SSS----------
------------S-----
------------------
-------X----------
---Q---XX---------
-------XXX--------
-------XXXX---}---
---{---XXXXX--X---
XXXXXXXXXXXXXXXXXX
