------------------
------------------
------------------
------------------
------------------
------------------
--SQ--------------
-------X----------
-------XX-----SS--
--Q----XXX--------
-------XXXX-------
-------XXXXX---}--
--{----XXXXXX--X--
XXXXX--XXXXXXXXXXX
