XXXXXXXXXXXX
XXX-X------X
X{-X---XXX-X
XXX-X------X
XXX------XXX
X---XXX--XXX
XX-X---XX--X
XX-X---XX--X
X--X-------X
XXX-XX-XX--X
XXXXXXXXXXXX
XXXXXXXXXXXX
XXX-XX-XXXXX
X---------}X
XXXXXXXXXXXX
