XXXXXXXXXXXX
X--X---XX--X
XXX-XXX----X
XXX-----XXXX
X{-X-XX-XXXX
XXX-XXXX---X
XXX-XXXX-XXX
X--X-XX--XXX
XX-X-----XXX
XX-X-XXXX--X
X----XXXX-XX
XXXX-XXXXXXX
XXXX--XXXXXX
X---------}X
XXXXXXXXXXXX
