XXXXXXXXXXXX
XX{----X---X
XXXXXXX----X
XXXXXXX----X
XXXXXXX----X
XXXX----XXXX
X-------XXXX
XXXXXX-X---X
XXXXXX-X-XXX
X------X-XXX
X----------X
XX-------XXX
XX-XXX-X-XXX
X---------}X
XXXXXXXXXXXX
