XXXXXXXXXXXX
X----------X
XXX---XX---X
XXX---XX---X
X{-X----XX-X
XXX-X--XXXXX
XXX--XXXXXXX
X----XXXXXXX
X-XXX--XXX-X
X----X-XXX-X
X----X----XX
XXXX-X---XXX
XXXX-----XXX
X----XX---}X
XXXXXXXXXXXX
