------------------
------------------
------------------
------------------
------------------
------------------
------------------
------SSS---------
------------------
------------------
------SQ--Q-------
--------------}---
--{-----------X---
XXXXX-------XXXXXX
META {"type": "solver", "value": "pysat-rc2"}
