XXXXXXXXXXXX
X----------X
XXXX-------X
XXXX---XXX-X
X{--XX-XXX-X
XXXXXXXXXX-X
XXXXXXXXXX-X
XXXXXXXXX--X
X---XX-----X
X-----X----X
X---X-X-X--X
X-----X--XXX
X-XXXX---XXX
X-----XX--}X
XXXXXXXXXXXX
META {"type": "solver", "value": "pysat-rc2"}
