------------------
------------------
------------------
------------------
------------------
------------------
------------------
------SS--Q-------
------------------
------------------
------Q----SS-----
---------------}--
--{------------X--
XXXXXX-------XXXXX
META {"type": "solver", "value": "pysat-rc2"}
