------------------
------------------
-----S------------
------------------
------------------
------------------
------------------
---S---------Q----
-------Q----------
----------S-------
------------------
---------------}--
---{-----------X--
XXXXXX-------XXXXX
