XXXXXXXXXXXX
XXXX---XX--X
XXXX-------X
XX{-X---X--X
XXXX--X-X-XX
XXXX----X--X
XX---------X
X---XX-XXX-X
XX--XX-----X
XX---------X
X-X-XX-XX--X
XXXXXXXXXXXX
XXXXXXXXXXXX
X---------}X
XXXXXXXXXXXX
