XXXXXXXXXXXX
X{--X--XX--X
XXX--X----XX
XXX--X-XXX-X
X--X-X----XX
X---X------X
X-XXXXX--XXX
X-XXXXX--XXX
X--------XXX
X--------XXX
XX-----X-XXX
X--------XXX
XX-------XXX
X--XX-XX--}X
XXXXXXXXXXXX
META {"type": "solver", "value": "pysat-rc2"}
