XXXXXXXXXXXX
XX{----X---X
XXXX------XX
XXXXXX----XX
XXXXXX-----X
XXXXXX----XX
X--XX--X-XXX
XX---X---XXX
X-------X--X
X-XXX---X--X
X-XXX---X--X
XX-------XXX
X--XXXX--XXX
X------XX-}X
XXXXXXXXXXXX
