------------------
------------------
------------------
------------------
---S--------------
------------------
------SSS---------
------------------
------------------
----------Q-------
------Q-----------
---------------}--
---{-----------X--
XXXXXX-------XXXXX
