------------------
------------------
------------------
------------------
------------------
------------------
------------------
--------SQQS------
-----S------------
------------------
----------X-------
----------XX---}--
--{-------XXX--X--
XXXXX-----XXXXXXXX
