------------------
------------------
------------------
---------S--------
---S--------------
------------------
---------Q--------
------------------
------X-----Q-----
------XX----------
------XXX---------
------XXXX-----}--
--{---XXXXX----X--
XXXXXXXXXXXXXXXXXX
