XXXXXXXXXXXX
X{--X-XX---X
XXX--X----XX
XXX--------X
X--XX--XXX-X
XXXXXX-XXX-X
XXXXXX-XXXXX
XXXXXX-XXXXX
XXXX----XX-X
X----------X
X-X-XXX----X
X-X----XXXXX
X-X----XXXXX
X----XX---}X
XXXXXXXXXXXX
