XXXXXXXXXXXX
X{--X---X--X
XXX----X--XX
XXX----X---X
X--XXX-X---X
X-----X---XX
XX---------X
XXX-XX-XXXXX
XXX-XX-XXXXX
X------XXXXX
XX---XXXXX-X
X-XX-XXXXXXX
X-XX---XXXXX
X---------}X
XXXXXXXXXXXX
META {"type": "solver", "value": "pysat-rc2"}
