XXXXXXXXXXXX
X{-X-------X
XXX--------X
XXX-----XXXX
X-----X-XXXX
X------X---X
XXXX---X-XXX
XXXX---X-XXX
X--------XXX
X----------X
X--------XXX
X-----XXXXXX
X-XXX-XXXXXX
X---------}X
XXXXXXXXXXXX
META {"type": "solver", "value": "pysat-rc2"}
