XXXXXXXXXXXX
X{-X-XX----X
XXX--------X
XXX--------X
X--XX-XX---X
XXXXXXXXXXXX
XXXXXXXXXXXX
XXXXXXXXXXXX
X--XX------X
X------XXX-X
X----X-----X
XXXX-X---XXX
XXXX-X---XXX
X-----XX--}X
XXXXXXXXXXXX
META {"type": "solver", "value": "pysat-rc2"}
