XXXXXXXXXXXX
X----------X
XXX-XXXXXXXX
XXX-XXXXXXXX
X{-X-------X
XXX---XX--XX
XXX---XX--XX
X--XXX--XX-X
X-----XXXXXX
XXX-X-XXXXXX
XXX-X--}XXXX
X---X-XXXXXX
XX-X--XXXXXX
X---XX-----X
XXXXXXXXXXXX
META {"type": "solver", "value": "pysat-rc2"}
