XXXXXXXXXXXX
X{-X-------X
XXX-XXX-X--X
XXX-----X--X
X---XXX-X--X
X-XXXXX----X
X-XXXXXX-XXX
X---XXXX-XXX
X--XXXXX-XXX
XX-XXXX----X
XX-----X-X-X
X---XXXXXXXX
X-X-XXXXXXXX
X---------}X
XXXXXXXXXXXX
META {"type": "solver", "value": "pysat-rc2"}
