XXXXXXXXXXXX
XXXXXXXXX-XX
XX{-XX-----X
XXXX-------X
XXXX--XX---X
X---XXXXXXXX
XXX-XXXXXXXX
XXX---XX---X
X--X-----XXX
X--X-XXX-XXX
X--X------}X
XXX-XXXXXXXX
XXX-XXXXXXXX
X----------X
XXXXXXXXXXXX
META {"type": "solver", "value": "pysat-rc2"}
