------------------
------------------
------------------
------------------
---------S--------
-----Q------------
------------------
------------------
-------S----------
---S--------------
----------Q-------
--------------}---
--{-----------X---
XXXXX------XXXXXXX
META {"type": "solver", "value": "pysat-rc2"}
