XXXXXXXXXXXX
XX{-X-XX-X-X
XXXX------XX
XXXX--XXX-XX
XX--X------X
X-X--------X
X--XXXX----X
X-XXXXX-X--X
X-XXXXX-X--X
X---XX--X--X
XX-------XXX
XX-XX----XXX
X--XX----XXX
X------XX-}X
XXXXXXXXXXXX
