------------------
------------------
------------------
------------------
------------------
---Q--------------
------SQ----------
------------------
------------------
------S---SS------
------------------
---------------}--
--{------------X--
XXXXX--XX----XXXXX
