------------------
------------------
-------------S----
------------------
----------Q-------
--------------S---
------------------
------------------
-------X----SS----
-------XX---------
-------XXX--------
-------XXXX---}---
--{----XXXXX--X---
XXXXX--XXXXXXXXXXX
META {"type": "solver", "value": "pysat-rc2"}
