------------------
------------------
------------------
------------------
------------------
------------------
----SQ------------
--------Q---------
--------------S---
------------------
----------SS------
------X--------}--
--{--XX--------X--
XXXXXXX------XXXXX
META {"type": "solver", "value": "pysat-rc2"}
