------------------
------------------
------------------
------------S-----
---------S--------
------------------
------------------
--Q---------------
-----X------------
-----XX-----------
-----XXX----------
-----XXXX------}--
--{--XXXXX-----X--
XXXXXXXXXXXXXXXXXX
