------------------
------------------
------------------
------------------
------------------
------------------
------------------
--------------S---
----Q---Q--S------
------------------
------------------
-----------X---}--
--{--------XX--X--
XXXXX------XXXXXXX
META {"type": "solver", "value": "pysat-rc2"}
