XXXXXXXXXXXX
XXXXX-XXXX-X
X{---XXXXXXX
XXX--XXXXXXX
XXX-X-XXX--X
X---X-----XX
X---X-----XX
X------X---X
XX-XXX-X---X
X------X--XX
X-XXXX-----X
X--------XXX
X---X----XXX
X------XX-}X
XXXXXXXXXXXX
