------------------
------------------
------------------
------------------
------------------
------------------
-------SSQ--------
------------------
------------------
-------Q----------
-----------S------
---------------}--
--{------------X--
XXXXXX-------XXXXX
META {"type": "solver", "value": "pysat-rc2"}
