------------------
------------------
------------------
------------------
------------------
------------------
-----SSQS---Q-----
------------------
------------------
------S--X--------
---------XX-------
---------XXX---}--
--{------XXXX--X--
XXXXX----XXXXXXXXX
