XXXXXXXXXXXX
X-XXX----X-X
XXXXX---X-XX
XXXXX------X
X{---XXXX--X
XXXXX-----XX
XXXXX-----XX
X-------X--X
X----XX-X-XX
XX---XX-X-XX
XX-XX------X
XX-XX----XXX
X--------XXX
X-XX---XX-}X
XXXXXXXXXXXX
