XXXXXXXXXXXX
XXX-----X--X
X{--XX----XX
XXX-XX-XX--X
XXX---XXXXXX
X-----XXXXXX
XX-XXX-XX--X
XXXXXX----XX
XXXXXX--X-XX
X-------X--X
X--X----X--X
XX-------XXX
X--XXXXX-XXX
X---------}X
XXXXXXXXXXXX
META {"type": "solver", "value": "pysat-rc2"}
