XXXXXXXXXXXXXXXXXXXX
XXXXXXXXXXXXXXXXXXXX
X------------------X
X------------------X
X------------------X
X----XXXXXXXXX------
X----XXXXXXXXX------
X-----------------}-
X---------------XXXX
X---------------XXXX
X---------------XXXX
XXXXXXX---XXX------X
XXXXXXX---XXX------X
XXXXXXX---XXX------X
-------------------X
-------------------X
--------{----------X
XXXXXXXXXXXXXXXXXXXX
XXXXXXXXXXXXXXXXXXXX
XXXXXXXXXXXXXXXXXXXX
META {"type": "solver", "value": "pysat-rc2"}
