XXXXXXXXXXXX
XXXX-X-XX--X
XXX--------X
X{-X-----XXX
XXX------XXX
XXX-X-XXX--X
XXX-X-XXXXXX
XX--X-XXXXXX
XX---------X
X--XXXX----X
X----------X
X---XXXX-XXX
X-X-XXXX-XXX
X---------}X
XXXXXXXXXXXX
