------------------
------------------
------------------
------------------
------------------
------------------
------------------
-----SSQS---------
------------------
------------------
-----S--X---------
--------XX----}---
--{-----XXX---X---
XXXXX---XXXXXXXXXX
META {"type": "solver", "value": "pysat-rc2"}
