------------------
------------------
------------------
------------------
---------------S--
------------------
---------Q--------
------------------
------X-------S---
------XX----------
------XXX---------
------XXXX----}---
--{---XXXXX---X---
XXXXXXXXXXXXXXXXXX
META {"type": "solver", "value": "pysat-rc2"}
