XXXXXXXXXXXX
X{-X-XXXXXXX
XXX--XXXXX-X
XXX---XX---X
X--XX---XX-X
XXXXXXXXXXXX
XXXXXXXXXXXX
X----------X
X--X-XXX-XXX
X--X-----XXX
X--X---XX-}X
XXX-XXXXXXXX
XXX-XXXXXXXX
X----------X
XXXXXXXXXXXX
